EASY
MONEY
100
ARENA
24x20
0 0 0 0 0 0 0 0 0 0 0 x 0 0 0 0 0 0 0 0 0 0 0 0
0 0 0 0 0 0 0 0 0 0 x 0 0 0 0 0 0 0 x 0 0 0 0 0
0 0 0 x 0 0 0 0 0 0 0 0 0 0 0 0 0 0 0 0 0 0 0 0
0 0 0 0 0 0 0 0 0 0 0 0 0 1 1 1 1 1 0 0 0 0 0 0
0 0 0 0 0 1 1 1 1 0 0 0 0 1 0 0 0 1 0 0 0 0 0 0
0 0 0 0 0 1 0 0 1 0 0 0 0 1 0 t 0 1 0 0 0 0 0 0
0 0 0 x 0 1 0 0 1 0 0 0 0 1 0 0 0 1 0 0 0 0 0 0
0 0 0 0 0 1 0 0 1 0 0 0 0 1 0 0 0 1 0 0 0 0 0 0
0 0 0 0 0 1 0 0 1 0 0 0 0 1 0 0 0 1 0 0 0 0 0 0
0 x 0 0 0 1 0 0 1 1 1 1 0 1 0 0 0 1 0 0 0 0 0 0
0 0 0 0 0 1 0 0 0 0 0 1 0 1 0 0 0 1 0 0 0 0 0 x
1 1 1 1 1 1 0 0 0 t 0 1 0 1 0 x 0 1 0 0 1 1 1 1
0 0 0 0 0 0 0 0 0 0 0 1 0 1 0 0 0 1 0 0 1 0 0 0
x 0 0 0 0 0 0 1 1 1 1 1 0 1 0 0 0 1 0 0 1 0 0 0
0 0 0 0 x 0 0 1 0 0 0 0 0 1 0 0 0 1 0 0 1 0 0 0
0 0 x 0 0 0 0 1 0 0 0 0 0 1 0 0 0 1 1 1 1 0 0 0
0 0 0 0 0 0 0 1 1 1 1 1 1 1 0 0 0 0 0 0 0 0 0 0
0 0 0 0 0 0 0 0 0 0 0 0 0 0 0 0 0 0 0 0 0 0 0 0
0 0 0 0 0 0 0 0 0 0 0 0 0 0 0 0 0 0 0 0 0 x 0 0
0 0 0 x 0 0 0 0 0 0 0 x 0 0 0 0 0 0 0 0 0 0 0 0
WAVES
size dist speed  hp    mSize  sprites
5_   1.8_ 1.5_   100_  0.50_  1