EASY
MONEY
10
ARENA
24x20
0 0 0 0 0 0 0 0 0 0 0 0 0 0 0 0 0 0 0 0 0 0 0 0
0 0 0 0 0 0 0 0 0 0 0 0 0 0 0 0 0 0 0 0 0 0 0 0
0 0 0 0 0 1 1 1 0 0 0 1 1 1 1 0 1 1 1 0 0 0 0 0
0 0 0 0 0 1 x 1 0 0 0 1 0 0 1 0 1 x 1 0 0 0 0 0
0 0 0 0 0 1 x 1 0 0 0 1 0 0 1 x 1 x 1 0 0 0 0 0
0 0 0 0 0 1 1 1 0 0 0 1 0 0 1 x 1 x 1 0 0 0 0 0
0 0 0 0 0 0 0 0 0 0 0 1 0 0 1 1 1 1 1 0 0 0 0 0
1 1 1 1 0 0 0 0 0 0 0 1 0 0 0 0 1 0 0 0 0 0 0 0
0 0 0 1 0 0 0 0 0 0 0 1 0 0 0 0 1 0 0 0 0 0 0 0
0 0 0 1 0 0 0 0 0 0 0 1 0 0 0 0 1 0 0 0 0 0 0 0
0 0 0 1 1 1 1 1 0 0 0 1 0 0 0 0 1 0 0 0 0 0 0 0
0 0 0 0 0 0 0 1 0 0 0 1 0 0 0 0 1 1 1 1 1 1 1 1
0 0 0 0 0 t 0 1 0 0 0 1 0 0 0 0 0 0 0 0 0 0 0 0
0 0 0 0 0 0 0 1 0 0 0 1 0 0 0 0 0 0 0 0 0 0 0 0
0 0 0 0 0 1 1 1 1 1 1 1 0 0 0 0 1 1 1 0 0 0 0 0
0 0 0 0 0 1 x 1 0 0 0 0 0 0 0 0 1 x 1 0 0 0 0 0
0 0 0 0 0 1 x 1 0 0 0 0 0 0 0 0 1 x 1 0 0 0 0 0
0 0 0 0 0 1 1 1 0 0 0 0 0 0 0 0 1 0 1 0 0 0 0 0
0 0 0 0 0 0 0 0 0 0 0 0 0 0 0 0 1 1 1 0 0 0 0 0
0 0 0 0 0 0 0 0 0 0 0 0 0 0 0 0 0 0 0 0 0 0 0 0
WAVES
size dist speed  hp    mSize  sprites
8_   1.5_ 1.0_   100_  0.35_  1
5_   3_   2.0_   100_  0.40_  2
3_   3_   1.0_   600_  0.30_  0