JUST FOR THE MENU BACKGROUND
MONEY
0
ARENA
28x20
0 0 0 0 0 0 0 0 0 0 0 x 0 0 0 0 0 0 0 0 0 0 0 0 0 0 0 0
0 0 x 0 0 0 0 0 0 0 x 0 0 0 0 0 0 0 x 0 0 0 0 0 x 0 0 0
0 0 x x 0 0 0 0 0 0 0 1 1 1 1 1 1 1 0 0 0 0 0 0 0 0 x 0
0 0 0 0 0 0 0 0 x 0 0 1 0 0 0 0 0 1 0 0 x 0 0 0 0 0 0 0
0 0 0 0 0 0 0 0 0 0 0 1 0 0 0 0 0 1 0 0 0 0 0 0 0 0 0 0
1 1 1 1 1 1 1 1 1 1 1 1 1 1 1 0 0 1 0 0 0 0 0 x 0 0 0 0
0 0 0 x 0 0 0 0 0 0 0 1 0 x 1 x 0 1 0 0 0 0 0 0 0 0 0 0
0 0 0 0 0 x 0 0 0 x 0 1 x 0 1 0 0 1 0 0 0 0 0 0 0 0 x 0
0 0 0 0 0 0 0 0 0 0 0 1 1 1 1 0 x 1 0 x 0 0 0 0 0 0 0 0
0 x 0 0 0 0 0 0 x 0 0 0 x 0 0 x 0 1 0 0 0 0 x 0 0 0 0 x
0 0 0 0 x 0 0 0 0 0 0 0 0 x 0 0 0 1 0 0 0 0 0 x 0 0 0 0
0 0 0 0 0 0 0 x 0 0 x 0 0 0 0 0 0 1 0 x 0 0 0 0 0 0 0 0
0 0 0 0 1 1 1 1 1 1 1 1 1 1 1 1 1 1 0 0 0 0 0 0 0 0 0 0
x 0 0 0 1 0 0 0 x 0 0 0 0 0 0 0 0 0 0 0 0 x 0 0 0 x 0 0
0 0 0 0 1 0 0 x 0 0 0 0 0 x 0 0 0 x 0 0 0 0 0 0 x 0 0 0
0 0 x 0 1 0 x 0 0 0 0 x 0 0 x 0 0 0 0 0 x 0 0 x 0 0 0 0
0 0 0 0 1 0 0 0 0 0 0 0 0 0 0 0 0 0 0 0 0 0 0 0 0 0 0 0
0 0 0 0 1 1 1 1 1 1 1 1 1 1 1 1 1 1 1 1 1 1 1 1 1 1 1 1
0 0 0 0 0 0 0 0 x 0 0 0 0 0 0 0 0 0 0 0 0 x 0 0 0 0 0 0
0 0 0 x 0 0 0 0 0 0 0 x 0 0 0 0 0 0 0 0 0 0 0 0 0 x 0 0
WAVES