Zigzag
MONEY
20
ARENA
24x20
0 0 0 0 0 0 0 0 0 0 0 0 0 0 0 0 0 0 0 0 0 0 0 0
0 0 0 0 0 0 0 0 0 0 0 0 0 0 0 0 0 0 0 0 0 0 0 0
0 0 0 0 0 0 0 0 0 0 0 1 1 1 1 1 0 0 0 0 0 0 0 0
0 0 0 0 0 0 0 0 0 0 0 1 0 0 0 1 0 0 0 0 0 0 0 0
0 0 0 1 1 1 1 1 0 0 0 1 0 t 0 1 0 0 0 0 0 0 0 0
0 0 0 1 0 0 0 1 0 x 0 1 0 0 0 1 0 0 0 0 0 0 0 0
0 0 0 1 0 x 0 1 0 0 0 1 0 x 0 1 0 0 0 0 0 0 0 0
0 x 0 1 0 0 0 1 0 x 0 1 0 0 0 1 0 x 0 0 0 x 0 0
0 0 0 1 0 x 0 1 0 0 0 1 0 x 0 1 0 0 0 0 0 0 0 0
1 1 1 1 0 0 0 1 0 x 0 1 0 0 0 1 0 x 0 1 1 1 1 1
0 0 0 0 0 x 0 1 0 0 0 1 0 x 0 1 0 0 0 1 0 0 0 0
0 x 0 0 0 0 0 1 0 x 0 1 0 0 0 1 0 x 0 1 0 x 0 0
0 0 0 0 0 x 0 1 0 0 0 1 0 x 0 1 0 0 0 1 0 0 0 0
0 0 0 0 0 0 0 1 0 x 0 1 0 0 0 1 0 t 0 1 0 0 0 0
0 0 0 0 0 0 0 1 0 0 0 1 0 x 0 1 0 0 0 1 0 0 0 0
0 0 0 0 0 0 0 1 0 x 0 1 0 0 0 1 1 1 1 1 0 0 0 0
0 0 0 0 0 0 0 1 0 0 0 1 0 0 0 0 0 0 0 0 0 0 0 0
0 0 0 0 0 0 0 1 1 1 1 1 0 0 0 0 0 0 0 0 0 0 0 0
0 0 0 0 0 0 0 0 0 0 0 0 0 0 0 0 0 0 0 0 0 0 0 0
0 0 0 0 0 0 0 0 0 0 0 0 0 0 0 0 0 0 0 0 0 0 0 0
WAVES
size dist speed  hp    value  mSize  sprites
5_   1.8_ 1.5_   400_  1_     0.50_  1