Zigzag
MONEY
20
ARENA
24x20
0 0 0 0 0 0 0 0 0 0 0 0 0 0 0 0 0 0 0 0 0 0 0 0
0 0 0 0 0 0 0 0 0 0 0 0 0 0 0 0 0 0 0 0 0 0 0 0
0 0 0 0 0 0 0 0 0 0 0 1 1 1 1 1 0 0 0 0 0 0 0 0
0 0 0 0 0 0 0 0 0 0 0 1 0 0 0 1 0 0 0 0 0 0 0 0
0 0 0 1 1 1 1 1 0 0 0 1 0 t 0 1 0 0 0 0 0 0 0 0
0 0 0 1 0 0 0 1 0 x 0 1 0 0 0 1 0 0 0 0 0 0 0 0
0 0 0 1 0 x 0 1 0 0 0 1 0 x 0 1 0 0 0 0 0 0 0 0
0 x 0 1 0 0 0 1 0 x 0 1 0 0 0 1 0 x 0 0 0 x 0 0
0 0 0 1 0 x 0 1 0 0 0 1 0 x 0 1 0 0 0 0 0 0 0 0
1 1 1 1 0 0 0 1 0 x 0 1 0 0 0 1 0 x 0 1 1 1 1 1
0 0 0 0 0 x 0 1 0 0 0 1 0 x 0 1 0 0 0 1 0 0 0 0
0 x 0 0 0 0 0 1 0 x 0 1 0 0 0 1 0 x 0 1 0 x 0 0
0 0 0 0 0 x 0 1 0 0 0 1 0 x 0 1 0 0 0 1 0 0 0 0
0 0 0 0 0 0 0 1 0 x 0 1 0 0 0 1 0 x 0 1 0 0 0 0
0 0 0 0 0 0 0 1 0 0 0 1 0 x 0 1 0 0 0 1 0 0 0 0
0 0 0 0 0 0 0 1 0 t 0 1 0 0 0 1 1 1 1 1 0 0 0 0
0 0 0 0 0 0 0 1 0 0 0 1 0 0 0 0 0 0 0 0 0 0 0 0
0 0 0 0 0 0 0 1 1 1 1 1 0 0 0 0 0 0 0 0 0 0 0 0
0 0 0 0 0 0 0 0 0 0 0 0 0 0 0 0 0 0 0 0 0 0 0 0
0 0 0 0 0 0 0 0 0 0 0 0 0 0 0 0 0 0 0 0 0 0 0 0
WAVES
size dist speed  hp    value  mSize  sprites
10_  1.5_ 2.5_   50_   1_     0.25_  0
7_   1.5_ 1.3_   150_  2_     0.35_  1
10_  1.2_ 2.5_   50_   1_     0.25_  2
5_   2.8_ 1.2_   300_  3_     0.40_  1
1_   1.8_ 1.4_   2000_ 10_    0.55_  0